XXXXXX
XPA- X
XAXC X
XWC SX
XXWXXX 