XX XX
X   X
X S X
X   X
XXXXX 