XXXXXX
X A  X
X  W X
X S  X
X    X
XXXXXX 