XXXXXXX
X  C  X
X  P  X
X  S  X
X     X
XXXXXXX 